0, , , , , ,#,#,#,#,#, , , , 
 ,#,#,#,#, ,#,#,#, , , ,#,#,1
 ,#,#,#,#, , , , , ,#,#,#, , 
#, ,#,#,#,#, , ,#,#,#, , , ,#
#, ,#, , , , ,#,#,#,#, ,#,#,#
#, , , ,#,#, , , , , , ,#,#,#
#, ,#, ,#,#, ,#,#,#,#,#,#,#,#
#,A,#, ,#,#,2, , , , , ,#,#,#
#,#,#, ,#,#,#,#,#,#,#, ,#,#,#
#,#,#, ,Z, ,3,#, , , , , , ,4