0, , ,#,#,#,#,#, , , , , , , 
 ,#, , , ,#,#,#, ,#,#,#,#,#, 
 ,#,#,#, , , , , , , , , ,#, 
 , ,B,#,#,#,#,#,#,#,#,#, ,#, 
 ,#, ,#,#,#,#,#,#,#,#,#, ,#,A
 ,#, ,#,#,3,Y, , , , , , ,#, 
 ,#, ,#,#, ,#,#,#,#,#,#,#,#, 
 ,#, ,#,#, , , , , , ,#,1, , 
 ,Z,2,#,#,#,#,#,#,#, ,#,#,#,#
#,#,#,#,#,#,#,#,#,#, , , , ,4
