0, , ,#,#,#,#,#, , , , , , , 
 ,#, , , ,#,#,#, ,#,#,#,#,#, 
 ,#,#,#, , , , , , , , , ,#, 
 , ,B,#,#,#,#,#,#,#,#,#, ,#, 
 ,#, ,#,#,#,#,#,#,#,#,#, ,#,A
 ,#, ,#,#,3,Y, , , , , , ,#, 
 ,#, ,#,#, ,#,#,#,#,#,#,#,#, 
 ,#,X,#,#,C, , , , , ,#,1, , 
 ,Z,2,#,#,#,#,#,#,#, ,#,#,#,#
#,#,#,#,#,#,#,#,#,#, , , , ,4
